1111111111111111111111
1   22   2 12  12    1
12 21    2    1  1   1
1       1  2  22   221
1   22 2        22   1
11  2          2   2 1
1  1      1    2 1   1
1     21        2   21
1  2 1 1    2      221
11    22  2     1    1
11   2     2  2   2 21
1       22 2 2222  1 1
1  2  2    2 2  2    1
12  2 2     122   2  1
1       221       22 1
1 2  12  2   1      11
12  1 2  2  21   2   1
122 1    11        111
1   2 1   212   12   1
11 1  1  2    2      1
12      1   2 1      1
1111111111111111111111