111111
1    1
1 22 1
1 22 1
1    1
111111